S....#####
.##.#.....
.##.#.####
...#.E....
###.#####.
...#......
.#########
.....#....
#####.####
..........
